csbu: p pː pʲ pʷ ps 
csbv: ʰb b bː bʲ bʷ bz bβ
csdu: t̪ t̪ʙ
csdv: d̪ 
csau: t tˣ ʰt tː tʲ tʷ t̺
csav: ʰd d dː dʲ
csru: ʈ 
csrv: ɖ 
cspu: c ʰc
cspv: ʰɟ ɟ
csvu: k kʲ kˣ ʰk kː ʰkʷ kʷ kʷː k̪ kʷʲ
csqu: kp 
csvv: ɡ ɡː ɡʷ
csuu: q qʷ 
csuv: ɢ 
csgu: ʔ ʔʲ
csaua: ts tsʲ
csava: dz
csoua: tʃ tʃʲ
csova: dʒ
csrua: ʈʂ
csrva: ɖʐ
cspua: tɕ cç
cspva: ɟʝ

cibu: ɓ̥ 
cibv: ɓ
ciau: ɗ̥ 
ciav: ɗ
cipv: ʄ
civv: ɠ

cabu: pʰ pʲʰ
cadu: t̪ʰ 
cadv: d̪ʰ
caau: tʰ tʲʰ 
caav: dʰ
caru: ʈʰ
capu: cʰ
cavu: kʰ kʲʰ
cauu: qʰ
caaua: tsʰ tsʲʰ
caoua: tʃʰ
carua: ʈʂʰ

cebu: pʼ
cebv: b̰ ʔb
cedu: t̪ʼ
ceau: tʼ tʲʼ t̰ t◌̰
ceav: d̰ ʔd
ceru: ʈʼ
cepu: cʼ c̰
cepv: ɟ̰  
cevu: kʼ kʲʼ kʷʼ k̰ kʷ̰ kʷ◌̰
cevv: ɡ̰ 
ceuu: qʼ
ceaua: tsʼ
ceava: ʔdʒ
ceoua: tʃʼ
cerua: ʈʂʼ

cpbu: mp mpʲ mɸʲ
cpbv: mb mbʲ 
cpau: nt ntʲ ns nsʲ
cpav: nd ndʲ 
cpvu: ŋk 
cpvv: ŋɡ ŋɡʷ
cpoua: ntʃ 
cpova: ndʒ 
cprua: ɳʈʂ 
cprva: ɳɖʐ 
cpaua: nts 
cpava: ndz ndzʲ 

cnbu: ʰm mʰ m̥ 
cnbv: m mʼ m̰ mʲ mʷ mː
cnlv: ɱ
cndv: n̪ 
cnau: ʰn nʰ n̥ 
cnav: n nʲ nː n̰
cnpu: ɲʰ
cnpv: ɲ ɲ̰ ɲː ɲ̥ 
cnvv: ŋ ŋʷ ŋ̥ 
cnxv: N 

cfbu: ɸ ɸʲ
cfbv: β βʲ 
cflu: fʷ f
cflv: v 
cfdu: θ s̪ θʲ
cfdv: ð 
cfau: s sʲ sʼ sʰ s̺
cfav: z 
cfru: ʂ
cfrv: ʐ 
cfou: ʃ
cfov: ʒ ʒ̺
cfpu: ɕ ç
cfpv: ʝ 
cfvu: x xʲ xl xʷ
cfvv: ɣ ɣʷ
cfuu: χ χʷ
cfuv: ʁ 
cfgu: h h̃ hʲ hʷ 

cxbv: β̞
cxlv: ʋ
cxdv: ð̞
cxav: ɹ
cxrv: ɻ
cxpu: ʰj
cxpv: j j̃ j̥ jʼ j̰ jː
cxvv: ɰ
cxqu: ʰw wʰ
cxqv: w w̃ wʼ w̰ wʲ wː ʔw
cxfv: ʕ

cldv: l̪ 
clau: l̥ ɬ ɺ̥ 
clav: l lʲ lʼ lː ɺ ɮ
clrv: ɭ ɭʲ
clpv: ʎ 
clvv: kl

ctau: ʰɾ
ctav: ɾ ɾ̃ ɾʲ ʔɾ 
ctru: ɽʰ
ctrv: ɽ

crau: r̥ 
crav: r
cruv: ʀ 
crbv: ʙ 

v7fu: i ĩ ḭ ḭ̃ iː ĩː iʰ 
v7fr: y ỹ 
v7cu: ɨ ɨ̃ ɨ̰ ɨː ɨ̃ː ɨ̘ ɨi 
v7cr: ʉ ʉ̃ ʉː 
v7bu: ɯ ɯ̃ ɯ̰ ɯː ɯ̃ː ɯi
v7br: u ũ ṵ ṵ̃ uː ũː uʰ 
v6fu: ɪ ɪ̃ ɪː
v6fr: ʏ 
v6br: ʊ ʊ̃ ʊː
v5fu: e ẽ ḛ ḛ̃ eː ẽː eʰ eu
v5fr: ø øː ø̃ 
v5cu: ɘ 
v5cr: ɵ ɵː 
v5bu: ɤ ɤ̃ ɤː 
v5br: o õ̰ o̰ õ oː õː oʰ oʲ õʲ o̝
v4cu: ə ə̃ ə̰ ə̰̃ əː ə̃ː 
v3fu: ɛ ɛ̃ ɛː ɛ̃ː
v3fr: œ œ̃
v3cu: ɜ 
v3bu: ʌ ʌ̃ ʌː ʌ̃ː 
v3br: ɔ ɔ̃ ɔː ɔ̃ː 
v2fu: æ æ̃ æː æ̃ː 
v2cu: ɐ̃ 
v1cu: a ã a̰ ã̰ aː ãː aʲ ãʲ aʲː aʰ 
v1bu: ɑ ɑ̃ ɑ̰ ɑː 
v1br: ɒ ɒ̃ ɒː ɒ̃ː

s: tone
s: nasal_harmony
s: laryngeal_harmony
